11111
10101
1CEP1
10101
10101
10101
11111