111111
1p1cc1
11ccc1
1cccc1
1cccc1
111c11
1cc0e1
111111