11111
10001
1CEP1
10101
10101
10101
11111