11111111111111111111111111111111111
10111111111111111111111111111111101
11111111111111111111111111111111111
11111111111111111111111111111111111
11111111111111111111111111111111111
11111111111111111111111111111111111
11111111111111111111111111111111111
11111111111111111111111111111111111
101111111111111111111111111cep11101
11111111111111111111111111111111111