111111111111111111111111111
10000000000000C0P0100000001
100000000001011E11100000001
1111111111111000000C0000001
100000000000000000000000001
100000000000000000000000001
111111111111111111111111111