111111111111111111111111111
100000000000C0000P100000001
100000000000E11111100000001
111111111111100000000000001
10000000000C000000000000001
100000000000000000000000001
111111111111111111111111111