111111111111111111111111111
1CCCCCCCCCCCC0000P100000001
10C000000000E11111100000001
111111111111100000000000001
100000000000000000000000001
100000000000000000000000001
111111111111111111111111111